%%%%%%%%%%%%%
%P   o .G  .%
%%%%%%%%%%%%%