%%%%%%%%%%%%%
%P         .%
%           %
%.     G    %
%%%%%%%%%%%%%