%%%%%%%%%%%%%%%%%%%%
%Po               .%
%%%%%% %%%%%%%%%%%%%
%%%%%%         %%%%%
%%%%%% %%%%%%%%%%%%%
%%%%%%G %%%%%%%%%%%%
%%      o         %%
%%%%%%%%   %%%%%%%%%
%G            G   .%
%%%%%%%%%%%%%%%%%%%%
