%%%%%%%%%%%%%
%P   .   G  %
%%%%%%%%%%%%%