%%%%%%%%%%%%%
%     .     %
% %%%%%%% % %
%           %
%           %
%           %
%           %
%       G   %
%           %
%           %
%           %
%           %
% P         %
%%%%%%%%%%%%%
