%%%%%%%%%%%%%
%   .       %
% %%%%%%% % %
%           %
%           %
%           %
%           %
%   G       %
%           %
%           %
%           %
%           %
%           %
%         P %
%%%%%%%%%%%%%
